000000000000000000000000000000
050000005555555555550500000000
050000005000000000050500000000
050000005040000000050500000000
050000005003000000050500000000
050000005000200000050500000000
050000005000010000050500000000
050000005000000000050500000000
055555505555555555550555555550
000000000000000000000000000000