111111111111111
105505505505501
155555555555551
103303303303301
133333333333331
102202202202201
122222222222221
101101101101101